NO ./textures/albillie.png
SO ./textures/maxborde.png
WE ./textures/gletilly.png
EA ./textures/lgalloux.png



F 120,120,120
C 173,216,230

000000  1111111111111111111111111
000000  1000000000110000000000001
        1011000001110000000000001
        1001000000000000000000001
111111111011000001110000000000001
100000000011000001110111111111111
11110111111111011100000010001
11110111111111011101010010001
11000000110101011100000000201
10000000000000001100000010001
10000000000000001101010010001
11000001110101011111011110N0111
11110111 1110101 101111010001
11111111 1111111 111111111111
