NO ./textures/albillie.png
SO ./textures/maxborde.png
WE ./textures/gletilly.png
EA ./textures/lgalloux.png



F 120,120,120
C 173,216,230

        1111111111111111111111111
        100D000000110000000000001
        1011000001110000001000001
        10010000000D000N010000001
111111111011000001110000000000001
10000000001100000111011111D111111
11110111111111D11100000010001
1111D111111111D11101010010001
110000001101010111000000D0001
10000000000000001100000010001
10000000000000001101010010001
11000001110101011111011110001
11110111 1110101 101111010001
11111111 1111111 111111111111